Декоративно-листяні рослини:

Фікуси: Бенджаміна, еластика, лірата.Драцени: Драцена, маргіната.
Монстера: Монстера делісіоза, монстера адінсоні.
Аглаонема: Срібний рай, Червона зірка.
Калатея: Лансифолія, Орбіфолія.
Папороті: Нефролепіс, Аспленум.
Філодендрон: Сканденс, Сердечко.
Дифенбахія: Компакта, Мартінс.
Сансевієрія: Тристрічкова, Місячна тінь.
Бегонії: Рекс, Королівська.
Кодієум: Екселент, Петру.
Традесканція: Зебрина, Пульчела.
Шефлера: Арборікола, Герда. 


Квітучі рослини:
Спатифілум: Жіноче щастя.
Бегонія: Королівська, Вечноцветущая.Антуріум: Червоний, Рожевий.
Цикламен: Перський, Неаполітанський.Азалія: Індійська, Японська.
Гібіскус: Китайська троянда.
Орхідеї: Фаленопсис, Дендробіум.
Жасмин: Кімнатний, Самбак.
Хризантема: Мультифлора, Класична.
Каланхое: Блоссфельда, Дегремона.
Кампанула: Дзвіночок.
Гарденія: Жасминовидна. 


Сукуленти:
Алое: Вера, Барбадоське.
Товстянка: Грошове дерево.Ечеверія: Агавовидна, Рожева.
Хавортія: Зубчаста, Смугаста.Седум: Криваво-червоний, Білий.
Красула: Овальна, Голден Дрегон.
Еоніум: Чорне Сонце, Дерево бажань. 


Пальми:
Арека: Золотиста.
Ховея: Форстера.Рапіс: Пальма леді.